####################################################################################################
#          #   #             #               #          #######      #       #             B     ###
#   ####   #   #   #####     #   ######      #          #            #   M   #   #####           ###
#   #      #       #         #   #           #########  #     #######       #   #   #           ####
#   #      ######  #   #######   #                #     #     #           #######   #   #####    ###
#   #               #       #    #######         #     #     ##########         #   #       #     ##
#   #######    M    #       #######              #     #               ######   #####   M   #    ###
#       #          #####    #     #              #     ###########     #    #          #####    ####
#       #    #########      #     #              #########             # M  #          #         ###
#   #####    #              #   M #####                #               #    #    #######          ##
#   #        #     ##########           #   ####       #######   M     #    #    #              ####
#   #        #     #              #######   #    ######           #####    #    #####          #####
#                  #    #         #    #####    #####             #                #####      ######
#         #####    #    #######   #####         #                 ###########   M   #          #####
#   M     #        #          #   #             #######                    #       #####        ####
#         #        ########## #   #                    ####               #####        #        ####
#         #           ####### #   #                                       #####        #        ####
#         #             ##### #   #                    ####               #####        #        ####
#         #           ####### #   #                    ##                #####        #         ####
#         #               ### #   #                    ####               #####        #        ####
#   #######    ####         #     #                    # M                #   #   M    #        ####
#       M         #         ##### ###########          #####             ###########   #######  ####
#   #######   M   ###  ##                #   # M           #     #               #          #   ####
#       #          #      #######       #####       ####   #####  ###########    #######    #   ####
#       #          #            #             ######  #   #   #   #     M  #          #     #   ####
#   ###########    #######      #    M             #  #   #   #####        #          #     #   ####
#       #                  #####             ######   #####          #######   #######      #   ####
#   #######  M   #########       #      ##########       #   #####      #      #       ########  ###
#         #      #               ####   #          #####    H#         #      #   #####         ####
#         ########   #######         #######       #         #         #      #   #             ####
#               #    #                M            #         #         #######   #####          ####
#   ########    #    #         ##############      #   #######   M                   #          ####
#   #           #    #   M     #                  #####          ####    #######     #          ####
#   #####   ##########         #    #######   M       #          #        #          #          ####
#       #   #        ###########   #     #            #######    #        #   ####   #   ####   ####
#   ######  #              #       #     #######      #    M#    #   M    #   #  #       #       ###
#       M   #   #####      #########         #  M     #     #   #####     #   #  ####### ###########
#   C   #   ##### #######               ######        #     #####         #####             #    ###
#       ####       #     ###########               ####         #########                    #   ###
#       #       M  #             ###### ###########    #######   #                            #  ###
#   M   #          #########     #                         M     #    #########   #####      #   ###
#   ###########       M   #      #####    M     ########         #          #      M  #      #   ###
#         M               #####      #############    #    ##########      #####     #  ######## ###
#        ######          #    ######            #     ######         ##        #     #           ###
#   H                     #           ###########         #   M      ###########     #           ###
#   ##########   ######   #######           M             #          #             ##########    ###
#        #              M #                      ###########         #                          M###
#   M    ########        # ########    ############         ##########   ####                   ####
#   #####       ########## #    #                                     M   #######             ######
####################################################################################################