####################
#     H       B    #
# # #  # #  #   ## #
#   #    # #  M    #
# #   R### # ##### #
#                  #
# #     ## ##   ## #
# #      # #     # #
# #   #  #    M  # #
#  #     # #   # # #
# #### #   #### ## #
#            #  M  #
#   #       #      #
#       ## #### ## #
###  M #     #   # #
# #### ### #### #  #
# #    #          ##
# ## #####       # #
#              #   #
####################