####################
#   M        ##    #
#  ###   M  ####   #
#     ####     #   #
#  ##   ##    ##   #
#   ####### ########
#   ##   H   ##    #
# M###   ##  ##    #
#   ## M ##  ##    #
#   ##   ##  ##    #
#   #######  ##    #
#   ##   ### ### M #
# M##    ##   ##   #
#   ##       ##    #
####################