####################################################################################################
#   ########   #######   #########     ######       ###########     #########  M  #########     ####
#   #       ####   #       M   ######       #########        ######        ####   #      ###    ####
#                                                 ##            #          #              #       ##
#   #           ## #              #            #         ###        ###        ## #        ##   ####
#   #######      ###   ##########   ########   #######   ####### M     ##  M     #    ######    ####
#         ##  M     #   ##       ###       ##          ##      ########    ###########         #####
#   ##########   #######   #######       #######   ######   ####      ########         #######  #  #
#         #######      #   #        ######          M              ##       #       ##      ## #   #
#####                                      #                  #                                    #
#   ######       ##  #######    M   #         ##########   ##############   #       ##  M   ##  ####
#   #        ########       ######   ##########        ######   M      ##   #########      #########
#   #   ######      ###      ##         ####    ######      ###   ############      ######      ####
##      #    #   ####### M  ###        ## M     ##   ##     ##    ##        #  ########        #####
#   #   # M  #######        ##   #######        ##   ##     ### M ##  M  ######               ######
#      #       ###         ##   #         #######   ##     #######    ######           M       #####
####         #                       # #                    ##                                    ##
#   #   ##########   #########   ###########    ##   ##             ######   ##########         ####
#   ##        ###        #######          ## M  ##   ##         M   ######     ####     #########  #
#   #####  M   ######       ######   ######    #####  #######   ##########  ######        ###    # #
#       #####        ###   ##    ##########        #####       ##       ######### M      ## M   #  #
#           #######    ### ###             #######      ##########       ####        ###  ##    #  #
#                                                                                                  #
#   #########     ####   ###   ###########      #########          #####    ###    ##    ##    #####
#   #           ##       ##                ####       ##           ##        ##    ##    ###########
#   ######### M ##   ######  ######### M   #          ##           ##        ##########        #####
#   ##       ######  ##      ##           ##########  ##    ########    ########        ############
#   ##########       ####### ##########  ##        ## ########     ##                #######    ####
#             ########       ##           ##        ##           ### #############     ###      ####
#   M  #####          ###### ##  #######  ##        ## ###########         #######               ###
#        ##   ###########    ##  ##       ########### ##      #####        ########  ######      ###
#   ##########             #######         ######     ###      ##     ######        ##   ####    ###
#          ##########   ###### M                     ##  #######   ###       ########    ## M    ###
#         ##       ###      ###########     ######   ##########   ###########      #########     ###
#   #######         ###        ###      ######        #          ##       #######               ####
#         ##        ##     M   ##  ######     #########   ##########      ##########   #######   ###
#   ######### M     ##  ####### ##  ##     ###            #                ########   ##         ###
#                                                   #                ##                            #
#        #####      ##        # ####### M  ##      ####   ##       ########    ##     ##   M     ###
#   ######     ##########    ##########   ##      ##     ##    ##        ##    ##########        ###
#         ######    ######        ##      ##      ## M  ##########        ##          #####      ###
#                                                                                                  #
#   ########        ##########   #######  ##      ########        ##      ###################### ###
#                  ###      ##           ##      ###### M  ######### M                  #######  ###
#   ##########   #####      #######      #########      ###########          ########            ###
#   #        ###########       M ######### M                       ##########         ##############
#                                                           H ################  ########         ###
#   ##########  ##########           #######          ###########            #########          ####
####################################################################################################