####################
#     H   C   B L  #
# # #  # #  #   ## #
#   #    # #  M    #
# #L  R### # ##### #
#         R        #
# #     ## ##   ## #
# #      # #     # #
# #   #  #    M  # #
#  #     # #   # # #
# #### #   #### ## #
#   L        #  M  #
#   #       #      #
#       ## #### ## #
###  M #     #   # #
# #### ### #### #  #
# #    #  R       ##
# ## #####       # #
#L             #   #
####################