####################
#            B     #
# # #  # #  #   ## #
#   #    # #  M    #
# #    ### # ##### #
#                  #
# #     ## ##   ## #
# #      # #     # #
# #   #  #    M  # #
#  #     # #   # # #
# #### #   #### ## #
#            #  M  #
#   #       #      #
#       ## #### ## #
###  M #     #   # #
# #### ### #### #  #
# #    #          ##
# ## #####       # #
#        H     #   #
####################