####################
#   B        C     #
# # #  # #  #   ## #
#   #    # #  M    #
# #    ### # ##### #
#                  #
# #     ## ##   ## #
# #      # #     # #
# #   #  #    M  # #
#  #     # #   # # #
# #### # R #### ## #
#            #  M  #
#   #       #      #
#       ## #### ## #
###  M #     #   # #
# #### ### #### #R #
# #    #          ##
# ## #####       # #
#        H     #   #
####################